20
10
....................
.xxxxxxxxxxxxxxxxxx.
....................
.x.P............m.x.
.x..............m.x.
.x.......T........x.
.xdmmdmmdmmdmmdmmdx.
....................
.xxxxxxxxxxxxxxxxxx.
....................