20
10
....................
.xxxxxxxxxxxxxxxxxx.
....................
.x.P..............x.
.x................x.
.x................x.
.x.33.33.33.33.33.x.
....................
.xxxxxxxxxxxxxxxxxx.
....................