20
10
00000000000000000000
01111111111111111110
00000000000000000000
01020000000000000010
01000000000000000010
01000000000000000010
01033033033033033010
00000000000000000000
01111111111111111110
00000000000000000000