20
10
....................
.xxxxxxxxxxxxxxxxxx.
.........C..........
.x.P...v....v...m.x.
.x..............m.x.
.x.......T........x.
.xdmmdmmdmmdmmdmmdx.
....................
.xxxxxxxxxxxxxxxxxx.
....................
d20
t20
g20
p20
l20