2
20
10
....................
.x.....xxxxxx.......
......xx....xxx.....
...t..x......xxx....
.p....d....c..xx....
......x.......xx....
......xxx...xxx..x..
..c....xxxxxxx..xxx.
.....x..........xxx.
....................
d5
t5
g0
p0
l0