20
10
....xx.............x
..x..xx...........xx
.xx...xx..........xx
.xxx...xxc.....c.xxx
.xx.....x..x.x...xxx
.....c..xxxxmxxxxxxx
.........xxx.xxx..xx
...t......xx.xx....x
.....p......m.......
............x.......
d0
t16
g0
p15
l0